############################################################
#..........................................................#
#.######.######.######.######.######.######.######.######..#
#..........................................................#
#.######.######.######.######.######.######.######.######..# 
#..........................................................#
#.######.######.######.######.######.######.######.######..# 
#..........................................................#
#.######.######.######.######.######.######.######.######..# 
#..........................................................#
#.######.######.######.######.######.######.######.######..# 
#..........................................................#
#.######.######.######.######.######.######.######.######..# 
#..........................................................#
############################################################