############################################################
#.........................................................X#
#.######.######.######.######.######.######.######.######.#
#...............X..........................................#
#.######.######.######.######.######.######.######.######.# 
#..................X.......................................#
#.######.######.######.######.######.######.######.######.# 
#..........................................................#
#.######.######.######.######.######.######.######.######.# 
#..........................................................#
############################################################